1111111111111111111111111111111111111111111111111111111111
1000000000000000000000000000000000000000000000000000000001
1000011000000000111111111111111111111111000000000000000001
10000110000E0000111111111111111111111111000000000000000001
1000011000000000111111111111111111111111000000000000000001
1000011000000000111111111111111111111111000000000000000001
1000011000000000000000111111110000000000000000000000000001
100001100000C000000000111111110000000000000000000000000001
1000011000000000000000111111110000000000000000000000000001
1000011000010000000000111111110000000000000000000000000001
1000011000111100000000111111110000000000000000000000000001
1000011000111100000000111111110000000000000000000000000001
1000011000111100000000111111110000000000000000000000000001
10000110001111000000001111111100000000C0000000000000000001
10000110001111000000001111111100000000C0000000000000000001
1000011000111100000000111111111111111111111111111111111111
1000011000111100000000111111111111111111111111111111111111
1000011000111100000000111111111111111111111111111111111111
1000011000111100000000111111111111111111111111111111111111
1000011000111100000000111111111111111111111111111111111111
1000011000111100000000111111110000000000000000000000000001
1000011000000000000000111111110000000000000000000000000001
100001100000000000000011111111000000P000000000000000000001
1000011111111111111100111111110000000000000000000000000001
1000011111111111111100111111110000000000000000000000000001
1000011111111111111100000000000000000000000000000000000001
1000011111111111111100000000000000000000000000000000000001
1000011111111111111100000000000000000000000000000000000001
1000011000000000000000000000000000000000000000000000000001
1000011000000000000000000000000000000000000000000000000001
1111111111111111111111111111111111111111111111111111111111